
supply_area={
	id=1
	name="SUPPLYAREA_1"
	value=12
	states={
		1 7 10 11 23 25 26 29 30 31 34 35 36 38 44 45 48 49 52 54 55 58 60 64 67 69 72 73 75 77 83 85 86 90 92 96 97 98
		101 104 106 109 115 119 121 122 125 130 131 132 136 142 146 162 168 176 180 184 191 194 195 203 204 217 220 265 266
		274 276 284 286 289 295 296 299 306 307 309 311 314 316 324 328 330 331 341 343 350 355 358 362 436 444 456 458 480
		482 492 501 503 505 511 513 533 540 569 593 633 652 672 676 737 768 778 781 787 803 816 823 829 834 844 848 852 853 856 859 865
		874 887 892 896 898 903 907 913 915 926 931 944 954 958 960 961 962 966 972 975 992 993 1049 1050 1058 1060 1063 1068 1083
		1087 1088 1090 1094 1099 1100 1103 1105 1108 1113 1125 1146 1150 1154 1156 1159 1160 1161 1164 1165 1166 1169 1171 1175
		1176 1177 1178 1182 1184 1189 1190 1191 1192 1193 1234 1235 1249
	}
}
